"DOTA_Tooltip_ability_hell_beast_aura"	"哥布林光环"
"DOTA_Tooltip_ability_hell_beast_aura_Description"	"提升50%%的攻击力、攻击速度与移动速度"
"DOTA_Tooltip_modifier_beast_aura_buff"	"哥布林光环"
"DOTA_Tooltip_modifier_beast_aura_buff_Description"	"提升50%%的攻击力、攻击速度与移动速度"
"DOTA_Tooltip_ability_boss_beat"	"清醒拍打"
"DOTA_Tooltip_ability_boss_beat_Description"	"一记强力的脸部拍打，造成5000点伤害与0.1秒晕眩"
"DOTA_Tooltip_ability_boss_stone"	"岩石印记"
"DOTA_Tooltip_ability_boss_stone_Description"	"该单位增加%resistance%%%的魔法抗性"
"DOTA_Tooltip_ability_boss_jump_strike"	"全力重击"
"DOTA_Tooltip_ability_boss_jump_strike_Description"	"使用全力跃起下击，对目标400范围造成12000点伤害并晕眩2秒"
"DOTA_Tooltip_ability_dog_wound"	"撕裂"
"DOTA_Tooltip_ability_dog_wound_Description"	"攻击时吸取目标1000点生命并攻击时减少目标20点护甲，持续30秒"
"DOTA_Tooltip_ability_boss_rage"	"狂暴"
"DOTA_Tooltip_ability_boss_rage_Description"	"大幅度提高攻速与移速，但会受到50%%额外伤害"
"DOTA_Tooltip_ability_dragon_energy_ball"	"龙息"
"DOTA_Tooltip_ability_dragon_energy_ball_Description"	"对目标造成30%%最大生命值伤害"
"DOTA_Tooltip_ability_boss_chaos_land"	"焦土"
"DOTA_Tooltip_ability_boss_chaos_land_Description"	"每秒对周围的单位造成%damage%点伤害"
"DOTA_Tooltip_ability_boss_chaos_fall"	"混沌陨石"
"DOTA_Tooltip_ability_boss_chaos_fall_Description"	"对目标600范围造成20000点伤害与1秒晕眩"
"DOTA_Tooltip_ability_boss_absorb"	"根茎吸收"
"DOTA_Tooltip_ability_boss_absorb_Description"	"放出根茎缠绕目标并吸收精华作为自身的养分，对目标造成10000点伤害并恢复自身40000点生命，持续4秒"
"DOTA_Tooltip_ability_boss_green_protect"	"绿色保护着你"
"DOTA_Tooltip_ability_boss_green_protect_Description"	"绿色保护着你，提升40点护甲与魔法抗性并减少40%%的伤害，同时生命回复提升4000点，持续10秒"
"DOTA_Tooltip_ability_boss_overgrowth"	"扎根"
"DOTA_Tooltip_ability_boss_overgrowth_Description"	"重新将树根扎入地下，以降低100%%的移动速度为代价束缚周围900范围单位，初始造成1000点伤害之后每秒造成500点伤害，同时吸收大地养分每秒回复4%%的生命，持续12秒"
"DOTA_Tooltip_ability_boss_soulbody"	"幽魂态"
"DOTA_Tooltip_ability_boss_soulbody_Description"	"减少60%%的物理伤害同时提高60%%的受到的魔法伤害"
"DOTA_Tooltip_ability_boss_soulconnect"	"灵魂链接"
"DOTA_Tooltip_ability_boss_soulconnect_Description"	"被链接的单位伤害死灵龙时会受到50%%的反馈伤害，反弹伤害有0.2秒的冷却。"
"DOTA_Tooltip_ability_boss_soulclash"	"灵魂冲击"
"DOTA_Tooltip_ability_boss_soulclash_Description"	"暂时冲散目标灵魂，造成60%%最大生命的伤害，在之后30秒内会逐渐回复30%%的生命"
"DOTA_Tooltip_ability_boss_fire_stun"	"烈焰之拳"
"DOTA_Tooltip_ability_boss_fire_stun_Description"	"攻击有20%%的几率击晕目标并造成%damage%伤害"
"DOTA_Tooltip_ability_boss_fire_land"	"地狱炎爆"
"DOTA_Tooltip_ability_boss_fire_land_Description"	"攻击有10%%的几率击晕600范围单位并造成%damage%点伤害，受到攻击时有5%%的几率触发"
"DOTA_Tooltip_ability_boss_fire_reborn"	"狱火燎原"
"DOTA_Tooltip_ability_boss_fire_reborn_Description"	"每秒回复1%%的生命，每次攻击回复1000点生命，触发烈焰之拳时回复10000点生命，触发地狱爆炎时回复50000点生命"

"DOTA_Tooltip_ability_arcane_attack"	"奥术天球"
"DOTA_Tooltip_ability_arcane_attack_Description"	"每次攻击都附加一个伤害加深效果，该效果作用于所有伤害。"
"DOTA_Tooltip_modifier_arcane_attack"	"奥术天球"
"DOTA_Tooltip_modifier_arcane_attack_Description"	"每次攻击都附加一个伤害加深效果"
"DOTA_Tooltip_modifier_arcane_attack_debuff"	"奥术侵蚀"
"DOTA_Tooltip_modifier_arcane_attack_debuff_Description"	"该单位将受到额外的伤害"

"DOTA_Tooltip_ability_arcane_attack_bonus_damage"	"%伤害加深："
"DOTA_Tooltip_ability_original_crash"	"原始冲击"
"DOTA_Tooltip_ability_original_crash_Description"	"对敌人造成敌人等级与奥术冲击叠加数量为一定系数的伤害"
"DOTA_Tooltip_ability_original_crash_bonus_damage"	"%伤害加深："
"DOTA_Tooltip_ability_hit_back"	"击退"


		"DOTA_Tooltip_ability_demon_sun_strike"	"毁天灭地"
		"DOTA_Tooltip_ability_demon_sun_strike_Description"	"召唤大规模阳炎冲击对周围的单位造成伤害。"