"DOTA_Tooltip_ability_item_chui_1"	"巨石钉锤"
"DOTA_Tooltip_ability_item_chui_1_Description"	"<h1>被动：重击</h1>攻击有一定%stun_chance%%%的几率对目标周围单位释放闪电并造成晕眩\n<font color=\"#337ab7\">副手装备只能装备一件</font><br></br>一整块巨大石头打造的钉锤"
"DOTA_Tooltip_ability_item_chui_1_Lore"	"这一锤子下来不是开玩笑的"
"DOTA_Tooltip_ability_item_chui_1_bonus_attack_speed"	"+攻击速度"
"DOTA_Tooltip_ability_item_chui_1_bonus_damage"	"+攻击力"
"DOTA_Tooltip_ability_item_chui_1_bonus_health"	"+生命值"
"DOTA_Tooltip_ability_item_chui_1_bonus_health_regen"	"+生命回复"
"DOTA_Tooltip_ability_item_chui_1_bonus_mana"	"+魔法值"
"DOTA_Tooltip_ability_item_chui_1_bonus_mana_regen"	"+魔法回复"
"DOTA_Tooltip_ability_item_chui_1_bonus_stats"	"+全属性"
"DOTA_Tooltip_ability_item_chui_1_stun_cooldown"	"+晕眩冷却"
"DOTA_Tooltip_ability_item_chui_1_stun_duration"	"+晕眩时间"
"DOTA_Tooltip_ability_item_chui_2"	"碎骨锤"
"DOTA_Tooltip_ability_item_chui_2_Description"	"<h1>被动：重击</h1>攻击有一定%stun_chance%%%的几率击晕目标并对周围单位释放闪电\n<font color=\"#337ab7\">副手装备只能装备一件</font><br></br>这把大锤可以轻易粉碎对方的防御能力"
"DOTA_Tooltip_ability_item_chui_2_Lore"	"对着脑袋来一下可不是开玩笑的"
"DOTA_Tooltip_ability_item_chui_2_bonus_attack_speed"	"+攻击速度"
"DOTA_Tooltip_ability_item_chui_2_bonus_damage"	"+攻击力"
"DOTA_Tooltip_ability_item_chui_2_bonus_health"	"+生命值"
"DOTA_Tooltip_ability_item_chui_2_bonus_health_regen"	"+生命回复"
"DOTA_Tooltip_ability_item_chui_2_bonus_mana"	"+魔法值"
"DOTA_Tooltip_ability_item_chui_2_bonus_mana_regen"	"+魔法回复"
"DOTA_Tooltip_ability_item_chui_2_bonus_stats"	"+全属性"
"DOTA_Tooltip_ability_item_chui_2_stun_cooldown"	"+晕眩冷却"
"DOTA_Tooltip_ability_item_chui_2_stun_duration"	"+晕眩时间"
"DOTA_Tooltip_ability_item_chui_3"	"聚能电锤"
"DOTA_Tooltip_ability_item_chui_3_Description"	"<h1>被动：重击</h1>攻击有一定%stun_chance%%%的几率击晕目标并对周围单位释放闪电\n<font color=\"#337ab7\">副手装备只能装备一件</font><br></br>一个地精工程师改造的大锤，充电后能有效的麻痹敌人"
"DOTA_Tooltip_ability_item_chui_3_Lore"	"小心使用不要电到自己"
"DOTA_Tooltip_ability_item_chui_3_bonus_attack_speed"	"+攻击速度"
"DOTA_Tooltip_ability_item_chui_3_bonus_damage"	"+攻击力"
"DOTA_Tooltip_ability_item_chui_3_bonus_health"	"+生命值"
"DOTA_Tooltip_ability_item_chui_3_bonus_health_regen"	"+生命回复"
"DOTA_Tooltip_ability_item_chui_3_bonus_mana"	"+魔法值"
"DOTA_Tooltip_ability_item_chui_3_bonus_mana_regen"	"+魔法回复"
"DOTA_Tooltip_ability_item_chui_3_bonus_stats"	"+全属性"
"DOTA_Tooltip_ability_item_chui_3_stun_cooldown"	"+晕眩冷却"
"DOTA_Tooltip_ability_item_chui_3_stun_duration"	"+晕眩时间"
"DOTA_Tooltip_ability_item_chui_4"	"雷光战锤"
"DOTA_Tooltip_ability_item_chui_4_Description"	"<h1>被动：重击</h1>攻击有一定%stun_chance%%%的几率击晕目标并对周围单位释放闪电\n<font color=\"#337ab7\">副手装备只能装备一件</font><br></br>经过雷电洗礼的战锤，不时施放出雷霆之力"
"DOTA_Tooltip_ability_item_chui_4_Lore"	"施放出雷霆之力能有效的麻痹敌人"
"DOTA_Tooltip_ability_item_chui_4_bonus_attack_speed"	"+攻击速度"
"DOTA_Tooltip_ability_item_chui_4_bonus_damage"	"+攻击力"
"DOTA_Tooltip_ability_item_chui_4_bonus_health"	"+生命值"
"DOTA_Tooltip_ability_item_chui_4_bonus_health_regen"	"+生命回复"
"DOTA_Tooltip_ability_item_chui_4_bonus_mana"	"+魔法值"
"DOTA_Tooltip_ability_item_chui_4_bonus_mana_regen"	"+魔法回复"
"DOTA_Tooltip_ability_item_chui_4_bonus_stats"	"+全属性"
"DOTA_Tooltip_ability_item_chui_4_stun_cooldown"	"+晕眩冷却"
"DOTA_Tooltip_ability_item_chui_4_stun_duration"	"+晕眩时间"
"DOTA_Tooltip_ability_item_chui_5"	"雷神之锤"
"DOTA_Tooltip_ability_item_chui_5_Description"	"<h1>主动：静电之触</h1>移除重击冷却，持续10秒\n<h1>被动：重击</h1>攻击有一定%stun_chance%%%的几率击晕目标并对周围单位释放闪电\n<font color=\"#337ab7\">副手装备只能装备一件</font><br></br>雷神索尔的武器，无穷无尽的雷电"
"DOTA_Tooltip_ability_item_chui_5_Lore"	"这把武器发动起来不给敌人任何喘息的机会"
"DOTA_Tooltip_ability_item_chui_5_bonus_attack_speed"	"+攻击速度"
"DOTA_Tooltip_ability_item_chui_5_bonus_damage"	"+攻击力"
"DOTA_Tooltip_ability_item_chui_5_bonus_health"	"+生命值"
"DOTA_Tooltip_ability_item_chui_5_bonus_health_regen"	"+生命回复"
"DOTA_Tooltip_ability_item_chui_5_bonus_mana"	"+魔法值"
"DOTA_Tooltip_ability_item_chui_5_bonus_mana_regen"	"+魔法回复"
"DOTA_Tooltip_ability_item_chui_5_bonus_stats"	"+全属性"
"DOTA_Tooltip_ability_item_chui_5_stun_cooldown"	"+晕眩冷却"
"DOTA_Tooltip_ability_item_chui_5_stun_duration"	"+晕眩时间"
"DOTA_Tooltip_ability_item_craft_chui"	"打造锤"
"DOTA_Tooltip_ability_item_craft_chui_Description"	"花费一点钱让工匠帮你打造装备"
"DOTA_Tooltip_ability_item_craft_chui_Lore"	"这个工匠似乎从上古战争就存在"
"DOTA_Tooltip_ability_item_craft_dun"	"打造盾"
"DOTA_Tooltip_ability_item_craft_dun_Description"	"花费一点钱让工匠帮你打造装备"
"DOTA_Tooltip_ability_item_craft_dun_Lore"	"这个工匠似乎从上古战争就存在"
"DOTA_Tooltip_ability_item_craft_fu"	"打造斧"
"DOTA_Tooltip_ability_item_craft_fu_Description"	"花费一点钱让工匠帮你打造装备"
"DOTA_Tooltip_ability_item_craft_fu_Lore"	"这个工匠似乎从上古战争就存在"
"DOTA_Tooltip_ability_item_craft_shu"	"打造书"
"DOTA_Tooltip_ability_item_craft_shu_Description"	"花费一点钱让工匠帮你打造装备"
"DOTA_Tooltip_ability_item_craft_shu_Lore"	"这个工匠似乎从上古战争就存在"
"DOTA_Tooltip_ability_item_dun_1"	"深红壁垒之盾"
"DOTA_Tooltip_ability_item_dun_1_Description"	"<h1>被动：防御</h1>减少%damage_block%%%所受到的伤害\n<font color=\"#337ab7\">副手装备只能装备一件</font><br></br>巨大的多重盾牌"
"DOTA_Tooltip_ability_item_dun_1_Lore"	"防御高的代价一般都是非常的重"
"DOTA_Tooltip_ability_item_dun_1_bonus_armor"	"+护甲"
"DOTA_Tooltip_ability_item_dun_1_bonus_attack_speed"	"+攻击速度"
"DOTA_Tooltip_ability_item_dun_1_bonus_health"	"+生命值"
"DOTA_Tooltip_ability_item_dun_1_bonus_health_regen"	"+生命回复"
"DOTA_Tooltip_ability_item_dun_1_bonus_mana"	"+魔法值"
"DOTA_Tooltip_ability_item_dun_1_bonus_mana_regen"	"+魔法回复"
"DOTA_Tooltip_ability_item_dun_1_bonus_resistance"	"+魔法抗性"
"DOTA_Tooltip_ability_item_dun_1_bonus_stats"	"+全属性"
"DOTA_Tooltip_ability_item_dun_2"	"龙骨之盾"
"DOTA_Tooltip_ability_item_dun_2_Description"	"<h1>被动：防御</h1>减少%damage_block%%%所受到的伤害\n<font color=\"#337ab7\">副手装备只能装备一件</font><br></br>巨龙骨头打造的盾牌"
"DOTA_Tooltip_ability_item_dun_2_Lore"	"巨龙的骨骼非常的坚硬，所以很难加工"
"DOTA_Tooltip_ability_item_dun_2_bonus_armor"	"+护甲"
"DOTA_Tooltip_ability_item_dun_2_bonus_attack_speed"	"+攻击速度"
"DOTA_Tooltip_ability_item_dun_2_bonus_health"	"+生命值"
"DOTA_Tooltip_ability_item_dun_2_bonus_health_regen"	"+生命回复"
"DOTA_Tooltip_ability_item_dun_2_bonus_mana"	"+魔法值"
"DOTA_Tooltip_ability_item_dun_2_bonus_mana_regen"	"+魔法回复"
"DOTA_Tooltip_ability_item_dun_2_bonus_resistance"	"+魔法抗性"
"DOTA_Tooltip_ability_item_dun_2_bonus_stats"	"+全属性"
"DOTA_Tooltip_ability_item_dun_3"	"风十字盾"
"DOTA_Tooltip_ability_item_dun_3_Description"	"<h1>被动：防御</h1>减少%damage_block%%%所受到的伤害\n<font color=\"#337ab7\">副手装备只能装备一件</font><br></br>刻画风之法阵的十字盾牌"
"DOTA_Tooltip_ability_item_dun_3_Lore"	"能有效运用风的力量抵御伤害"
"DOTA_Tooltip_ability_item_dun_3_bonus_armor"	"+护甲"
"DOTA_Tooltip_ability_item_dun_3_bonus_attack_speed"	"+攻击速度"
"DOTA_Tooltip_ability_item_dun_3_bonus_health"	"+生命值"
"DOTA_Tooltip_ability_item_dun_3_bonus_health_regen"	"+生命回复"
"DOTA_Tooltip_ability_item_dun_3_bonus_mana"	"+魔法值"
"DOTA_Tooltip_ability_item_dun_3_bonus_mana_regen"	"+魔法回复"
"DOTA_Tooltip_ability_item_dun_3_bonus_resistance"	"+魔法抗性"
"DOTA_Tooltip_ability_item_dun_3_bonus_stats"	"+全属性"
"DOTA_Tooltip_ability_item_dun_4"	"蓝宝石魔法盾"
"DOTA_Tooltip_ability_item_dun_4_Description"	"<h1>被动：防御</h1>减少%damage_block%%%所受到的伤害\n<font color=\"#337ab7\">副手装备只能装备一件</font><br></br>魔法师用法术加持过宝石盾"
"DOTA_Tooltip_ability_item_dun_4_Lore"	"魔法与物理的组合让防御无懈可击"
"DOTA_Tooltip_ability_item_dun_4_bonus_armor"	"+护甲"
"DOTA_Tooltip_ability_item_dun_4_bonus_attack_speed"	"+攻击速度"
"DOTA_Tooltip_ability_item_dun_4_bonus_health"	"+生命值"
"DOTA_Tooltip_ability_item_dun_4_bonus_health_regen"	"+生命回复"
"DOTA_Tooltip_ability_item_dun_4_bonus_mana"	"+魔法值"
"DOTA_Tooltip_ability_item_dun_4_bonus_mana_regen"	"+魔法回复"
"DOTA_Tooltip_ability_item_dun_4_bonus_resistance"	"+魔法抗性"
"DOTA_Tooltip_ability_item_dun_4_bonus_stats"	"+全属性"
"DOTA_Tooltip_ability_item_dun_5"	"埃癸斯盾"
"DOTA_Tooltip_ability_item_dun_5_Description"	"<h1>主动：绝对防御</h1>免疫所有伤害，并对魔法免疫，持续10秒\n<h1>被动：防御</h1>减少%damage_block%%%所受到的伤害\n赫菲斯托为神打造的双面神盾\n<font color=\"#337ab7\">副手装备只能装备一件</font>"
"DOTA_Tooltip_ability_item_dun_5_Lore"	"一面来自宙斯，一面来自雅典娜"
"DOTA_Tooltip_ability_item_dun_5_bonus_armor"	"+护甲"
"DOTA_Tooltip_ability_item_dun_5_bonus_attack_speed"	"+攻击速度"
"DOTA_Tooltip_ability_item_dun_5_bonus_health"	"+生命值"
"DOTA_Tooltip_ability_item_dun_5_bonus_health_regen"	"+生命回复"
"DOTA_Tooltip_ability_item_dun_5_bonus_mana"	"+魔法值"
"DOTA_Tooltip_ability_item_dun_5_bonus_mana_regen"	"+魔法回复"
"DOTA_Tooltip_ability_item_dun_5_bonus_resistance"	"+魔法抗性"
"DOTA_Tooltip_ability_item_dun_5_bonus_stats"	"+全属性"
"DOTA_Tooltip_ability_item_fu_1"	"长柄战斧"
"DOTA_Tooltip_ability_item_fu_1_Description"	"<h1>被动：分裂攻击</h1>对目标周围%cleave_radius%范围敌方单位造成%cleave_percent%%%的溅射伤害，并且有%waist_cut_chance%%%几率腰斩目标，造成目标当前生命值%waist_cut_percent%%%的纯粹伤害。\n<font color=\"#337ab7\">副手装备只能装备一件</font><br></br>长柄的战斧，大大提高了攻击范围"
"DOTA_Tooltip_ability_item_fu_1_Lore"	"用来对付大范围的敌人再好不过了"
"DOTA_Tooltip_ability_item_fu_1_bonus_armor"	"护甲："
"DOTA_Tooltip_ability_item_fu_1_bonus_attack_speed"	"+攻击速度"
"DOTA_Tooltip_ability_item_fu_1_bonus_damage"	"+攻击力"
"DOTA_Tooltip_ability_item_fu_1_bonus_health"	"+生命值"
"DOTA_Tooltip_ability_item_fu_1_bonus_health_regen"	"+生命回复"
"DOTA_Tooltip_ability_item_fu_1_bonus_mana"	"+魔法值"
"DOTA_Tooltip_ability_item_fu_1_bonus_mana_regen"	"+魔法回复"
"DOTA_Tooltip_ability_item_fu_1_bonus_resistance"	"魔法抗性："
"DOTA_Tooltip_ability_item_fu_1_bonus_stats"	"+全属性"
"DOTA_Tooltip_ability_item_fu_1_cleave_radius"	"+分裂半径"
"DOTA_Tooltip_ability_item_fu_1_damage_block"	"%物理伤害减少："
"DOTA_Tooltip_ability_item_fu_2"	"血腥锯齿锤斧"
"DOTA_Tooltip_ability_item_fu_2_Description"	"<h1>被动：分裂攻击</h1>对目标周围%cleave_radius%范围敌方单位造成%cleave_percent%%%的溅射伤害，并且有%waist_cut_chance%%%几率腰斩目标，造成目标当前生命值%waist_cut_percent%%%的纯粹伤害。\n<font color=\"#337ab7\">副手装备只能装备一件</font><br></br>无论是锯齿还是锤都能轻易的收割敌人的生命"
"DOTA_Tooltip_ability_item_fu_2_Lore"	"用这把血腥的战斧来收割战场再适合不过了"
"DOTA_Tooltip_ability_item_fu_2_bonus_attack_speed"	"+攻击速度"
"DOTA_Tooltip_ability_item_fu_2_bonus_damage"	"+攻击力"
"DOTA_Tooltip_ability_item_fu_2_bonus_health"	"+生命值"
"DOTA_Tooltip_ability_item_fu_2_bonus_health_regen"	"+生命回复"
"DOTA_Tooltip_ability_item_fu_2_bonus_mana"	"+魔法值"
"DOTA_Tooltip_ability_item_fu_2_bonus_mana_regen"	"+魔法回复"
"DOTA_Tooltip_ability_item_fu_2_bonus_stats"	"+全属性"
"DOTA_Tooltip_ability_item_fu_2_cleave_radius"	"+分裂半径"
"DOTA_Tooltip_ability_item_fu_3"	"日耀魔眼战斧"
"DOTA_Tooltip_ability_item_fu_3_Description"	"<h1>被动：分裂攻击</h1>对目标周围%cleave_radius%范围敌方单位造成%cleave_percent%%%的溅射伤害，并且有%waist_cut_chance%%%几率腰斩目标，造成目标当前生命值%waist_cut_percent%%%的纯粹伤害。\n<font color=\"#337ab7\">副手装备只能装备一件</font><br></br>这把可怕的战斧看上一眼都会觉得颤抖"
"DOTA_Tooltip_ability_item_fu_3_Lore"	"魔眼一族使用日耀石打造的战斧"
"DOTA_Tooltip_ability_item_fu_3_bonus_attack_speed"	"+攻击速度"
"DOTA_Tooltip_ability_item_fu_3_bonus_damage"	"+攻击力"
"DOTA_Tooltip_ability_item_fu_3_bonus_health"	"+生命值"
"DOTA_Tooltip_ability_item_fu_3_bonus_health_regen"	"+生命回复"
"DOTA_Tooltip_ability_item_fu_3_bonus_mana"	"+魔法值"
"DOTA_Tooltip_ability_item_fu_3_bonus_mana_regen"	"+魔法回复"
"DOTA_Tooltip_ability_item_fu_3_bonus_stats"	"+全属性"
"DOTA_Tooltip_ability_item_fu_3_cleave_radius"	"+分裂半径"
"DOTA_Tooltip_ability_item_fu_4"	"符文战斧"
"DOTA_Tooltip_ability_item_fu_4_Description"	"<h1>被动：分裂攻击</h1>对目标周围%cleave_radius%范围敌方单位造成%cleave_percent%%%的溅射伤害，并且有%waist_cut_chance%%%几率腰斩目标，造成目标当前生命值%waist_cut_percent%%%的纯粹伤害。\n<font color=\"#337ab7\">副手装备只能装备一件</font><br></br>上古流传下来的传奇武器，上面刻画的神秘符文具有强大的力量"
"DOTA_Tooltip_ability_item_fu_4_Lore"	"符文的力量再次证明魔法与物理的组合的强大"
"DOTA_Tooltip_ability_item_fu_4_bonus_attack_speed"	"+攻击速度"
"DOTA_Tooltip_ability_item_fu_4_bonus_damage"	"+攻击力"
"DOTA_Tooltip_ability_item_fu_4_bonus_health"	"+生命值"
"DOTA_Tooltip_ability_item_fu_4_bonus_health_regen"	"+生命回复"
"DOTA_Tooltip_ability_item_fu_4_bonus_mana"	"+魔法值"
"DOTA_Tooltip_ability_item_fu_4_bonus_mana_regen"	"+魔法回复"
"DOTA_Tooltip_ability_item_fu_4_bonus_stats"	"+全属性"
"DOTA_Tooltip_ability_item_fu_4_cleave_radius"	"+分裂半径"
"DOTA_Tooltip_ability_item_fu_5"	"地狱熔岩战斧"
"DOTA_Tooltip_ability_item_fu_5_Description"	"<h1>主动：灰烬</h1>使得溅射范围、溅射伤害、腰斩几率加倍，持续10秒。\n<h1>被动：分裂攻击</h1>对目标周围%cleave_radius%范围敌方单位造成%cleave_percent%%%的溅射伤害，并且有%waist_cut_chance%%%几率腰斩目标，造成目标当前生命值%waist_cut_percent%%%的纯粹伤害。\n<font color=\"#337ab7\">副手装备只能装备一件</font><br></br>一把用地狱熔岩锻造的战斧，上面流转着熔岩核心之力"
"DOTA_Tooltip_ability_item_fu_5_Lore"	"地狱熔岩能轻易的粉碎敌人"
"DOTA_Tooltip_ability_item_fu_5_bonus_attack_speed"	"+攻击速度"
"DOTA_Tooltip_ability_item_fu_5_bonus_damage"	"+攻击力"
"DOTA_Tooltip_ability_item_fu_5_bonus_health"	"+生命值"
"DOTA_Tooltip_ability_item_fu_5_bonus_health_regen"	"+生命回复"
"DOTA_Tooltip_ability_item_fu_5_bonus_mana"	"+魔法值"
"DOTA_Tooltip_ability_item_fu_5_bonus_mana_regen"	"+魔法回复"
"DOTA_Tooltip_ability_item_fu_5_bonus_stats"	"+全属性"
"DOTA_Tooltip_ability_item_fu_5_cleave_radius"	"+分裂半径"
"DOTA_Tooltip_ability_item_recipe_chui_1"	"巨石钉锤合成卷轴"
"DOTA_Tooltip_ability_item_recipe_chui_2"	"碎骨锤合成卷轴"
"DOTA_Tooltip_ability_item_recipe_chui_3"	"聚能电锤合成卷轴"
"DOTA_Tooltip_ability_item_recipe_chui_4"	"雷光战锤合成卷轴"
"DOTA_Tooltip_ability_item_recipe_chui_5"	"雷神之锤合成卷轴"
"DOTA_Tooltip_ability_item_recipe_dun_1"	"深红壁垒之盾合成卷轴"
"DOTA_Tooltip_ability_item_recipe_dun_2"	"龙骨之盾合成卷轴"
"DOTA_Tooltip_ability_item_recipe_dun_3"	"风十字盾合成卷轴"
"DOTA_Tooltip_ability_item_recipe_dun_4"	"蓝宝石魔法盾合成卷轴"
"DOTA_Tooltip_ability_item_recipe_dun_5"	"埃癸斯盾合成卷轴"
"DOTA_Tooltip_ability_item_recipe_fu_1"	"长柄战斧合成卷轴"
"DOTA_Tooltip_ability_item_recipe_fu_2"	"血腥锯齿锤斧合成卷轴"
"DOTA_Tooltip_ability_item_recipe_fu_3"	"日耀魔眼战斧合成卷轴"
"DOTA_Tooltip_ability_item_recipe_fu_4"	"符文战斧"
"DOTA_Tooltip_ability_item_recipe_fu_5"	"地狱熔岩战斧合成卷轴"
"DOTA_Tooltip_ability_item_recipe_shu_1"	"鲜血之书合成卷轴"
"DOTA_Tooltip_ability_item_recipe_shu_2"	"生命之书合成卷轴"
"DOTA_Tooltip_ability_item_recipe_shu_3"	"冰霜之书合成卷轴"
"DOTA_Tooltip_ability_item_recipe_shu_4"	"火焰之书合成卷轴"
"DOTA_Tooltip_ability_item_recipe_shu_5"	"禁忌之书合成卷轴"
"DOTA_Tooltip_ability_item_shu_1"	"鲜血之书"
"DOTA_Tooltip_ability_item_shu_1_Description"	"<h1>被动：法术精通</h1>减少%cooldown_reduce%%%的技能冷却时间\n<font color=\"#337ab7\">副手装备只能装备一件</font><br></br>一本沾满血迹的魔法书"
"DOTA_Tooltip_ability_item_shu_1_Lore"	"上面画着一些难懂的法阵"
"DOTA_Tooltip_ability_item_shu_1_bonus_attack_speed"	"+攻击速度"
"DOTA_Tooltip_ability_item_shu_1_bonus_health"	"+生命值"
"DOTA_Tooltip_ability_item_shu_1_bonus_health_regen"	"+生命回复"
"DOTA_Tooltip_ability_item_shu_1_bonus_mana"	"+魔法值"
"DOTA_Tooltip_ability_item_shu_1_bonus_mana_regen"	"+魔法回复"
"DOTA_Tooltip_ability_item_shu_1_bonus_stats"	"+全属性"
"DOTA_Tooltip_ability_item_shu_2"	"生命之书"
"DOTA_Tooltip_ability_item_shu_2_Description"	"<h1>被动：法术精通</h1>减少%cooldown_reduce%%%的技能冷却时间\n<font color=\"#337ab7\">副手装备只能装备一件</font><br></br>一本生机勃勃的魔法书"
"DOTA_Tooltip_ability_item_shu_2_Lore"	"上面似乎有精灵在跳动"
"DOTA_Tooltip_ability_item_shu_2_bonus_attack_speed"	"+攻击速度"
"DOTA_Tooltip_ability_item_shu_2_bonus_health"	"+生命值"
"DOTA_Tooltip_ability_item_shu_2_bonus_health_regen"	"+生命回复"
"DOTA_Tooltip_ability_item_shu_2_bonus_mana"	"+魔法值"
"DOTA_Tooltip_ability_item_shu_2_bonus_mana_regen"	"+魔法回复"
"DOTA_Tooltip_ability_item_shu_2_bonus_stats"	"+全属性"
"DOTA_Tooltip_ability_item_shu_3"	"冰霜之书"
"DOTA_Tooltip_ability_item_shu_3_Description"	"<h1>被动：法术精通</h1>减少%cooldown_reduce%%%的技能冷却时间\n<font color=\"#337ab7\">副手装备只能装备一件</font><br></br>记载着寒冰奥秘的魔法书"
"DOTA_Tooltip_ability_item_shu_3_Lore"	"上面的寒冰之力甚至能冻结我的魔法"
"DOTA_Tooltip_ability_item_shu_3_bonus_attack_speed"	"+攻击速度"
"DOTA_Tooltip_ability_item_shu_3_bonus_health"	"+生命值"
"DOTA_Tooltip_ability_item_shu_3_bonus_health_regen"	"+生命回复"
"DOTA_Tooltip_ability_item_shu_3_bonus_mana"	"+魔法值"
"DOTA_Tooltip_ability_item_shu_3_bonus_mana_regen"	"+魔法回复"
"DOTA_Tooltip_ability_item_shu_3_bonus_stats"	"+全属性"
"DOTA_Tooltip_ability_item_shu_4"	"火焰之书"
"DOTA_Tooltip_ability_item_shu_4_Description"	"<h1>被动：法术精通</h1>减少%cooldown_reduce%%%的技能冷却时间\n<font color=\"#337ab7\">副手装备只能装备一件</font><br></br>记载着火焰奥秘的魔法书"
"DOTA_Tooltip_ability_item_shu_4_Lore"	"上面的火焰之力加快了我的魔法流动"
"DOTA_Tooltip_ability_item_shu_4_bonus_attack_speed"	"+攻击速度"
"DOTA_Tooltip_ability_item_shu_4_bonus_health"	"+生命值"
"DOTA_Tooltip_ability_item_shu_4_bonus_health_regen"	"+生命回复"
"DOTA_Tooltip_ability_item_shu_4_bonus_mana"	"+魔法值"
"DOTA_Tooltip_ability_item_shu_4_bonus_mana_regen"	"+魔法回复"
"DOTA_Tooltip_ability_item_shu_4_bonus_stats"	"+全属性"
"DOTA_Tooltip_ability_item_shu_5"	"禁忌之书"
"DOTA_Tooltip_ability_item_shu_5_Description"	"<h1>主动：启灵</h1>提升50%%的基础主属性并在持续时间内免疫物理伤害，持续10秒\n<h1>被动：法术精通</h1>减少%cooldown_reduce%%%的技能冷却时间\n<<font color=\"#337ab7\">副手装备只能装备一件</font><br></br>记载着禁忌法术的魔法书"
"DOTA_Tooltip_ability_item_shu_5_Lore"	"上面的禁忌之力让人颤抖"
"DOTA_Tooltip_ability_item_shu_5_bonus_attack_speed"	"+攻击速度"
"DOTA_Tooltip_ability_item_shu_5_bonus_health"	"+生命值"
"DOTA_Tooltip_ability_item_shu_5_bonus_health_regen"	"+生命回复"
"DOTA_Tooltip_ability_item_shu_5_bonus_mana"	"+魔法值"
"DOTA_Tooltip_ability_item_shu_5_bonus_mana_regen"	"+魔法回复"
"DOTA_Tooltip_ability_item_shu_5_bonus_stats"	"+全属性"
"DOTA_Tooltip_modifier_chui_active"	"静电之触"
"DOTA_Tooltip_modifier_chui_active_Description"	"击晕目标时将附带麻痹效果"
"DOTA_Tooltip_modifier_chui_debuff"	"麻痹"
"DOTA_Tooltip_modifier_chui_debuff_Description"	"减少攻击速度与移动速度"
"DOTA_Tooltip_modifier_dun_active"	"绝对防御"
"DOTA_Tooltip_modifier_dun_active_Description"	"免疫所有伤害，并对魔法免疫"
"DOTA_Tooltip_modifier_item_shu_active"	"启灵"
"DOTA_Tooltip_modifier_item_shu_active_Description"	"提升50%%的基础主属性"