"hero_statue_1"	"英雄历练碑"
"hero_statue_2"	"英雄历练碑"
"practicer"	"练习傀儡"
"kobold"	"哥布林"
"kobold_lord"	"哥布林领主"
"beast"	"熊怪"
"hell_beast"	"地狱熊怪"
"ancient_golem"	"远古花岗岩傀儡"
"ogre"	"食人魔"
"boss_ogre"	"食人魔领主"
"dog"	"食尸鬼"
"boss_dog"	"食尸鬼王"
"dragon_1"	"远古黑龙"
"dragon_2"	"远古魔龙"
"dragon_3"	"远古暗黑魔龙"
"boss_treant"	"远古树妖"
"boss_clotho"	"克洛托"
"boss_iapetos"	"伊阿珀托斯"
"boss_fire_demon"	"地狱火焰恶魔"
"boss_visage"	"死灵龙"